2.200000000000000000e+01 1.828792389898637738e-01
2.200000000000000000e+01 1.828792389898637738e-01
2.000000000000000000e+01 1.557942382124389569e-01
2.000000000000000000e+01 1.557942382124389569e-01
1.600000000000000000e+01 2.020305089104421359e-01
1.000000000000000000e+01 2.103515809558356153e-01
1.900000000000000000e+01 1.816681048781898788e-01
1.700000000000000000e+01 1.926642802132290944e-01
1.200000000000000000e+01 1.946247360403807469e-01
3.300000000000000000e+01 1.740776559556978520e-01
7.000000000000000000e+00 2.054120075044402749e-01
7.000000000000000000e+00 2.054120075044402749e-01
1.300000000000000000e+01 1.732657343801630168e-01
1.300000000000000000e+01 1.732657343801630168e-01
1.300000000000000000e+01 1.732657343801630168e-01
6.000000000000000000e+00 1.889822365046135988e-01
6.000000000000000000e+00 1.889822365046135988e-01
1.100000000000000000e+01 2.041241452319315364e-01
1.500000000000000000e+01 1.628655854961140736e-01
1.500000000000000000e+01 1.628655854961140736e-01
2.300000000000000000e+01 1.825741858350553581e-01
2.300000000000000000e+01 1.825741858350553581e-01
2.300000000000000000e+01 1.825741858350553581e-01
2.300000000000000000e+01 1.825741858350553581e-01
1.400000000000000000e+01 1.957400731715678299e-01
1.600000000000000000e+01 1.280368799328959750e-01
1.200000000000000000e+01 2.061965247105806143e-01
1.500000000000000000e+01 1.856953381770518607e-01
1.100000000000000000e+01 1.879778950992281039e-01
1.100000000000000000e+01 1.879778950992281039e-01
1.000000000000000000e+01 2.062842492517586723e-01
1.600000000000000000e+01 1.924500897298752622e-01
1.200000000000000000e+01 1.961161351381840445e-01
2.700000000000000000e+01 2.169304578186561638e-01
2.700000000000000000e+01 2.169304578186561638e-01
1.100000000000000000e+01 1.873171623163387978e-01
1.400000000000000000e+01 1.581138830084189706e-01
1.100000000000000000e+01 1.866633482366393537e-01
1.100000000000000000e+01 1.762268442125603518e-01
1.100000000000000000e+01 1.762268442125603518e-01
1.200000000000000000e+01 1.913897505877381888e-01
1.200000000000000000e+01 1.913897505877381888e-01
1.900000000000000000e+01 2.085144140570747706e-01
1.800000000000000000e+01 1.883108942886773662e-01
1.200000000000000000e+01 2.094269541458477490e-01
1.200000000000000000e+01 2.094269541458477490e-01
8.000000000000000000e+00 1.849000654084096973e-01
8.000000000000000000e+00 1.849000654084096973e-01
8.000000000000000000e+00 2.132007163556104146e-01
8.000000000000000000e+00 2.132007163556104146e-01
1.600000000000000000e+01 2.094269541458477490e-01
3.000000000000000000e+01 2.000000000000000111e-01
1.200000000000000000e+01 2.103515809558356153e-01
1.200000000000000000e+01 2.103515809558356153e-01
1.900000000000000000e+01 2.085144140570747706e-01
