9.000000000000000000e+00 1.471224715841249198e-01
2.200000000000000000e+01 1.208244186660353964e-01
2.200000000000000000e+01 2.098877400805567728e-01
2.200000000000000000e+01 2.098877400805567728e-01
2.200000000000000000e+01 2.098877400805567728e-01
2.200000000000000000e+01 2.098877400805567728e-01
1.600000000000000000e+01 1.630820182633605508e-01
1.600000000000000000e+01 2.020305089104421359e-01
4.100000000000000000e+01 1.851534400602094788e-01
1.100000000000000000e+01 1.231848482100297570e-01
1.100000000000000000e+01 1.231848482100297570e-01
1.400000000000000000e+01 1.949943939917579694e-01
1.400000000000000000e+01 1.949943939917579694e-01
9.000000000000000000e+00 1.153854688305884363e-01
1.100000000000000000e+01 1.807753815155467847e-01
1.100000000000000000e+01 1.807753815155467847e-01
1.200000000000000000e+01 1.834939608543934286e-01
1.200000000000000000e+01 1.834939608543934286e-01
2.200000000000000000e+01 1.810714920850370613e-01
1.700000000000000000e+01 1.822101292697509145e-01
1.700000000000000000e+01 1.822101292697509145e-01
1.700000000000000000e+01 1.822101292697509145e-01
2.000000000000000000e+01 1.512722552040128843e-01
1.200000000000000000e+01 1.725677569321074356e-01
1.200000000000000000e+01 1.725677569321074356e-01
1.000000000000000000e+01 1.896608104527204020e-01
1.000000000000000000e+01 2.020305089104421359e-01
1.000000000000000000e+01 2.020305089104421359e-01
1.000000000000000000e+01 1.205607055426030361e-01
1.000000000000000000e+01 1.205607055426030361e-01
1.400000000000000000e+01 2.032789070454354419e-01
1.400000000000000000e+01 2.032789070454354419e-01
2.300000000000000000e+01 1.751423610260146868e-01
2.300000000000000000e+01 1.751423610260146868e-01
1.200000000000000000e+01 1.207363221040737983e-01
1.100000000000000000e+01 2.041241452319315364e-01
1.800000000000000000e+01 1.635174850419321702e-01
1.800000000000000000e+01 1.635174850419321702e-01
1.800000000000000000e+01 1.635174850419321702e-01
1.800000000000000000e+01 1.635174850419321702e-01
7.000000000000000000e+00 1.601281538050871311e-01
7.000000000000000000e+00 1.601281538050871311e-01
2.000000000000000000e+01 1.544873731043652221e-01
2.000000000000000000e+01 1.544873731043652221e-01
2.000000000000000000e+01 1.544873731043652221e-01
1.200000000000000000e+01 1.704985848676183746e-01
1.800000000000000000e+01 1.906925178491184758e-01
1.800000000000000000e+01 1.906925178491184758e-01
1.800000000000000000e+01 1.906925178491184758e-01
1.800000000000000000e+01 1.906925178491184758e-01
1.800000000000000000e+01 1.906925178491184758e-01
1.200000000000000000e+01 2.061965247105806143e-01
1.700000000000000000e+01 1.798956907402886329e-01
1.200000000000000000e+01 2.045507374323065619e-01
2.500000000000000000e+01 1.705977984837351025e-01
2.100000000000000000e+01 1.737357854652358535e-01
1.400000000000000000e+01 1.700051002295114855e-01
1.400000000000000000e+01 1.850583025494013101e-01
1.400000000000000000e+01 1.850583025494013101e-01
1.400000000000000000e+01 1.850583025494013101e-01
1.600000000000000000e+01 1.601281538050871311e-01
1.600000000000000000e+01 1.601281538050871311e-01
1.700000000000000000e+01 1.976423537605236924e-01
1.000000000000000000e+01 1.793163150302081454e-01
7.000000000000000000e+00 1.712469363126854216e-01
7.000000000000000000e+00 1.765011274045519274e-01
7.000000000000000000e+00 1.834630774138222009e-01
1.200000000000000000e+01 1.727736851162720300e-01
1.000000000000000000e+01 1.793163150302081454e-01
1.800000000000000000e+01 1.910401799752175223e-01
1.800000000000000000e+01 1.910401799752175223e-01
1.800000000000000000e+01 1.988106931218860118e-01
1.000000000000000000e+01 1.896608104527204020e-01
1.800000000000000000e+01 1.717513466431815627e-01
1.000000000000000000e+01 1.856953381770518607e-01
2.000000000000000000e+01 1.595158068056740930e-01
2.700000000000000000e+01 1.687898945139444384e-01
1.000000000000000000e+01 1.776112083313469703e-01
1.000000000000000000e+01 1.776112083313469703e-01
1.000000000000000000e+01 1.776112083313469703e-01
1.100000000000000000e+01 1.762268442125603518e-01
1.100000000000000000e+01 1.762268442125603518e-01
9.000000000000000000e+00 1.607476073901373814e-01
1.300000000000000000e+01 1.341104451964550137e-01
1.500000000000000000e+01 1.876466562602003840e-01
1.500000000000000000e+01 1.876466562602003840e-01
1.800000000000000000e+01 1.961161351381840445e-01
1.800000000000000000e+01 2.141764684390596585e-01
1.200000000000000000e+01 1.935282499290458813e-01
1.200000000000000000e+01 1.935282499290458813e-01
2.300000000000000000e+01 1.220783750597460166e-01
2.300000000000000000e+01 1.220783750597460166e-01
1.600000000000000000e+01 2.054553570897080239e-01
1.600000000000000000e+01 2.054553570897080239e-01
1.600000000000000000e+01 2.054553570897080239e-01
1.000000000000000000e+01 2.041241452319315364e-01
1.000000000000000000e+01 2.041241452319315364e-01
1.000000000000000000e+01 2.041241452319315364e-01
1.000000000000000000e+01 2.041241452319315364e-01
1.000000000000000000e+01 2.041241452319315364e-01
1.000000000000000000e+01 2.041241452319315364e-01
1.000000000000000000e+01 2.041241452319315364e-01
